1
BBBBBBBBBBB
BBSBBBBBSBB
BBBBBSBBBBB
SSSBBBBBSSS
BBBBBBBBBBB
BBBBSSSBBBB
BSBBBBBBBSB
BBBBBBBBBBB
BBBBBEBBBBB
#
2
BBBBBBBBBBB
SSBSSBSSBSS
BBBBBBBBBBB
BSBBBSBBBSB
BBBBBBBBBBB
BBBBBBBBBBB
BBBBBBBBBBB
BBBBBBBBBBB
BBBBBBBBBBB
BBBBBBBBBBB
BBBBBBBBBBB
BBBBBEBBBBB
#
3
BBBBBBBBBBB
SBSBBBSBSBS
SBSSSBSBBBB
SBBBBBSBSBS
SSSBSSSSSBB
BBBBBBBSBBS
BBBBBBBSBSS
BBBBBBBBBBB
BBBBBBBBBBB
BBBBBBBBBBB
BBBBBBBBBBB
BBBBBEBBBBB
#